0000000E0000000000000000000
000FF00P00PP?P00PP?0000ZZPP
00PFFPPP00P00PP?P0P00?PZZ0P
00P0000HP?PPPP0P00?00P0000?
00?00PPP0000P00JJ0PPPHPP?0?
SPPP?P0000P?HPPJJ00P0P00PPP
00P00PPHPP?0P000000P0?00P00
00?0000?0P00PP?PPP?P0DD0P00
00P0BBPP0P0000P00P000DD0P00
00PPBB0P0PP??PHPPP?PPP00GG0
0000000E0000000000000000GG0
 